011111111111111111110
01K222222212222222K10
012112111212111211210
012222222222222222210
012112121111121211210
012222122212221222210
011112111212111211110
000012122222221210000
111112121101121211111
P22222221RRR12222222P
111112121111121211111
000012122222221210000
011112121111121211110
012222222212222222210
012112111212111211210
0122122222S2222212210
011212121111121212210
012222122212221222210
012111111212111111210
01K222222222222222K10
011111111111111111110
